####***####
#*S**#***##
########*##
##*******##
#***##*##*#
#*G*##****#
###########