*********#**#*#***#*
#**#*****#**#*#*****
##**##****#*****##*#
#****#****#*#*****#*
###***#******#****##
***##****#*#*****#*#
**##*******#*#***#**
##****####******#**#
###**##******##*****
*****#S**##*#******#
*****#****#*##**#***
*#***#**###*#*##****
#******#**#*********
**##******#****##*#*
#*#***#*#***#**##*#*
*##**##*******#****#
*##*##***G*#**#*#**#
#***#*##***#*#*#***#
*##****####*##******
*****#**************